XXXXXXXX
XOOOXOAX
XOXOXOXX
XOXOXOOX
XOXOXXOX
XOXOXOOX
XOXOOOXX
XBXXXXXX